36 36 36 36 36 36 36 36 36 36 36 36 36 36 36 36 36 36 36 36 36 36 36 36 36 36 36 36 36 36 36 36 36 36 36 36 36 36 36 36 36 36 36 36 36 36 36 36 36 36
36 36 36 36 36 36 36 36 36 36 36 36 36 36 36 36 36 36 36 36 36 36 36 36 36 36 36 36 36 36 36 36 36 36 36 36 36 36 36 36 36 36 36 36 36 36 36 36 36 36
36 36 36 36 36 36 36 36 36 36 36 36 36 36 36 36 36 36 36 36 36 36 36 36 36 36 36 36 36 36 36 36 36 36 36 36 36 36 36 36 36 36 36 36 36 36 36 36 36 36
36 36 36 36 36 36 36 36 36 36 36 36 36 36 36 36 36 36 36 36 36 36 36 36 36 36 36 36 36 36 36 36 36 36 36 36 36 36 36 36 36 36 36 36 36 36 36 36 36 36
36 36 36 36 36 36 36 39 11 11 11 11 11 11 11 11 11 11 11 11 11 11 11 11 11 11 11 11 11 11 11 11 11 11 11 11 11 11 11 11 11 11 37 36 36 36 36 36 36 36
36 36 36 36 36 36 39 14 10 10 10 10 10 10 10 10 10 10 10 10 10 10 10 10 10 10 10 10 10 10 10 10 10 10 10 10 10 10 10 10 10 10 12 37 36 36 36 36 36 36
36 36 36 36 36 39 14 10 10 10 10 10 10 10 10 10 10 10 10 10 10 10 10 10 10 10 10 10 10 10 10 10 10 10 10 10 10 10 10 10 10 10 10 16 36 36 36 36 36 36
36 36 36 36 36 16 10 10 10 10 10 10 10 10 10 10 10 10 10 10 10 10 10 10 24 10 10 10 10 10 10 10 10 10 10 10 10 10 10 10 10 10 10 16 36 36 36 36 36 36
36 36 36 36 36 17 10 10 10 10 10 10 10 10 10 10 10 10 10 10 10 10 10 10 10 10 10 10 10 10 10 10 10 10 10 10 10 10 10 10 10 10 10 16 36 36 36 36 36 36
36 36 36 36 36 17 10 10 10 10 10 10 10 10 10 10 10 10 10 10 10 10 10 10 10 10 10 10 10 10 10 10 10 10 10 10 10 10 10 10 10 10 10 16 36 36 36 36 36 36
36 36 36 36 36 17 10 10 10 35 35 35 35 35 35 35 10 10 10 10 10 10 10 10 10 10 10 10 10 10 10 10 10 10 10 10 10 10 10 10 10 10 10 16 36 36 36 36 36 36
36 36 36 36 36 17 10 10 10 35 32 32 32 32 32 35 10 10 10 10 10 10 24 10 10 10 10 10 10 10 10 10 10 10 10 10 10 10 10 10 10 10 10 16 36 36 36 36 36 36
36 36 36 36 36 17 10 10 10 35 32 32 32 32 32 35 10 42 42 42 42 42 42 42 42 42 42 42 42 42 42 42 42 42 42 42 42 10 10 10 10 10 10 16 36 36 36 36 36 36
36 36 36 36 36 17 10 10 10 35 32 32 32 32 32 35 10 46 46 46 46 46 46 46 46 46 46 46 46 46 46 46 46 46 46 46 46 10 10 10 10 10 10 16 36 36 36 36 36 36
36 36 36 36 36 17 10 10 10 35 32 32 32 32 32 35 48 41 41 41 41 41 41 41 41 41 41 41 41 41 41 41 41 41 41 41 41 50 10 10 10 10 10 16 36 36 36 36 36 36
36 36 36 36 36 17 10 10 10 35 32 32 32 32 32 35 52 41 44 41 44 41 44 41 44 41 44 41 44 41 44 41 44 41 44 41 41 52 10 10 10 10 10 16 36 36 36 36 36 36
36 36 36 36 36 17 10 10 10 35 35 35 35 35 32 35 52 41 41 41 41 41 41 41 41 41 41 41 41 41 41 41 41 41 41 41 41 52 10 10 10 10 10 16 36 36 36 36 36 36
36 36 36 36 36 17 10 10 10 10 10 10 10 10 10 10 52 47 47 47 47 47 47 47 47 47 47 47 47 47 47 47 47 47 47 47 47 52 10 10 10 10 10 16 36 36 36 36 36 36
36 36 36 36 36 17 10 10 10 10 10 10 10 10 10 10 52 42 42 42 42 42 42 42 42 42 42 42 42 42 42 42 42 42 42 42 42 52 10 10 10 10 10 16 36 36 36 36 36 36
36 36 36 36 36 36 15 10 10 10 10 10 10 10 10 10 52 10 10 10 10 10 10 10 10 10 10 10 10 10 10 10 10 10 10 10 10 52 10 10 10 10 10 16 36 36 36 36 36 36
36 36 36 36 36 36 17 10 10 10 10 10 10 10 10 10 52 10 10 10 10 10 10 10 10 10 10 10 10 10 10 10 10 10 10 10 10 52 10 10 10 10 10 16 36 36 36 36 36 36
36 36 36 36 36 36 17 10 10 10 10 10 10 10 10 10 52 10 10 10 10 10 10 10 10 10 10 10 10 10 10 10 10 10 10 10 10 52 10 10 10 10 10 16 36 36 36 36 36 36
36 36 36 36 36 36 17 10 10 10 10 10 10 10 10 10 52 10 10 10 10 10 10 10 10 10 10 10 10 10 10 10 10 10 10 10 10 52 10 10 10 10 10 16 36 36 36 36 36 36
36 36 36 36 36 36 17 10 10 10 10 10 10 10 10 10 52 10 10 10 10 18 25 25 25 20 10 10 10 10 10 10 10 10 10 10 10 52 10 10 10 10 10 16 36 36 36 36 36 36
36 36 36 36 36 36 17 10 10 10 10 10 10 10 10 10 52 10 10 10 10 29 23 23 23 28 10 10 10 10 10 10 10 10 10 10 10 52 10 10 10 10 10 16 36 36 36 36 36 36
36 36 36 36 36 36 17 10 10 10 10 10 10 10 10 10 52 10 10 10 10 23 23 23 23 23 10 10 10 10 10 10 10 10 10 10 10 52 10 10 10 10 10 16 36 36 36 36 36 36
36 36 36 36 36 36 17 10 10 10 10 10 10 10 10 10 52 10 10 10 10 23 23 23 23 23 10 10 10 10 10 10 10 10 10 10 10 52 10 10 10 10 10 16 36 36 36 36 36 36
36 36 36 36 36 36 17 10 10 10 10 10 10 10 10 10 52 10 10 10 10 23 23 23 23 23 10 10 10 10 10 10 10 10 10 10 10 52 10 10 10 10 10 16 36 36 36 36 36 36
36 36 36 36 36 36 17 10 10 10 10 10 10 34 10 10 52 10 10 10 10 30 23 23 23 31 10 10 10 10 10 10 10 10 10 10 10 52 10 10 10 10 10 16 36 36 36 36 36 36
36 36 36 36 36 36 17 10 10 10 10 10 10 10 10 10 52 10 10 10 10 19 24 24 24 21 10 10 10 10 10 10 10 10 10 10 10 52 10 10 10 10 13 38 36 36 36 36 36 36
36 36 36 36 36 36 17 10 10 10 10 10 10 10 10 10 52 10 10 10 10 10 10 10 10 10 10 10 10 10 10 10 10 10 10 10 10 52 10 10 10 10 16 36 36 36 36 36 36 36
36 36 36 36 36 36 17 10 10 10 10 10 10 10 10 10 52 10 10 10 10 10 10 10 10 10 10 10 10 10 10 10 10 10 10 24 10 52 10 10 10 10 16 36 36 36 36 36 36 36
36 36 36 36 36 36 17 10 10 10 10 10 10 10 10 10 52 10 10 10 10 10 10 10 10 10 10 10 10 10 10 10 34 10 10 10 10 52 10 10 10 10 16 36 36 36 36 36 36 36
36 36 36 36 36 36 17 10 10 10 10 10 10 10 10 10 52 10 10 10 10 10 10 10 10 10 10 10 10 10 10 10 10 10 10 10 10 52 10 10 10 10 16 36 36 36 36 36 36 36
36 36 36 36 36 36 17 10 10 10 10 10 10 10 10 10 52 10 10 10 10 10 10 10 10 10 10 10 10 10 10 10 10 10 10 10 10 52 10 10 10 10 16 36 36 36 36 36 36 36
36 36 36 36 36 36 17 10 10 10 10 10 10 10 10 10 52 10 10 10 10 10 10 10 10 10 10 10 10 10 10 10 10 10 10 10 10 52 10 10 10 10 16 36 36 36 36 36 36 36
36 36 36 36 36 36 17 10 10 10 10 10 10 10 10 10 52 10 10 10 10 10 10 10 10 10 10 10 10 10 10 10 10 10 10 10 10 52 10 10 10 10 16 36 36 36 36 36 36 36
36 36 36 36 36 36 17 10 10 10 10 10 10 10 10 10 52 10 10 10 10 34 10 10 10 10 10 10 10 10 10 10 10 10 10 10 10 52 10 10 10 10 16 36 36 36 36 36 36 36
36 36 36 36 36 36 17 10 10 10 10 10 10 10 10 10 49 41 41 41 41 41 41 41 41 41 41 41 41 41 41 41 41 41 41 41 41 51 10 10 10 10 16 36 36 36 36 36 36 36
36 36 36 36 36 36 17 10 10 10 10 10 10 10 10 10 10 10 10 10 10 10 10 10 10 10 10 10 10 10 10 10 10 10 10 10 10 10 10 10 10 10 16 36 36 36 36 36 36 36
36 36 36 36 36 36 17 10 10 10 10 10 10 10 10 10 10 10 10 10 10 10 10 10 10 10 10 10 10 10 10 10 10 10 10 10 10 10 10 10 10 10 16 36 36 36 36 36 36 36
36 36 36 36 36 36 17 10 10 10 10 10 10 10 10 10 10 10 10 10 10 10 10 10 10 10 10 10 10 10 10 10 10 10 10 10 10 10 10 10 10 10 16 36 36 36 36 36 36 36
36 36 36 36 36 36 17 10 10 10 10 10 10 10 10 10 10 10 10 10 10 10 10 10 10 24 10 10 10 10 10 10 10 10 10 10 10 10 10 10 13 22 38 36 36 36 36 36 36 36
36 36 36 36 36 36 36 15 10 10 10 10 10 10 10 10 10 10 10 10 10 10 10 10 10 10 10 10 10 10 10 10 10 10 10 10 10 10 10 10 16 38 36 36 36 36 36 36 36 36
36 36 36 36 36 36 36 36 15 22 22 22 22 22 22 22 22 22 22 22 22 22 22 22 22 22 22 22 22 22 22 22 22 22 22 22 22 22 22 22 38 36 36 36 36 36 36 36 36 36
36 36 36 36 36 36 36 36 36 36 36 36 36 36 36 36 36 36 36 36 36 36 36 36 36 36 36 36 36 36 36 36 36 36 36 36 36 36 36 36 36 36 36 36 36 36 36 36 36 36
36 36 36 36 36 36 36 36 36 36 36 36 36 36 36 36 36 36 36 36 36 36 36 36 36 36 36 36 36 36 36 36 36 36 36 36 36 36 36 36 36 36 36 36 36 36 36 36 36 36
36 36 36 36 36 36 36 36 36 36 36 36 36 36 36 36 36 36 36 36 36 36 36 36 36 36 36 36 36 36 36 36 36 36 36 36 36 36 36 36 36 36 36 36 36 36 36 36 36 36
36 36 36 36 36 36 36 36 36 36 36 36 36 36 36 36 36 36 36 36 36 36 36 36 36 36 36 36 36 36 36 36 36 36 36 36 36 36 36 36 36 36 36 36 36 36 36 36 36 36
36 36 36 36 36 36 36 36 36 36 36 36 36 36 36 36 36 36 36 36 36 36 36 36 36 36 36 36 36 36 36 36 36 36 36 36 36 36 36 36 36 36 36 36 36 36 36 36 36 36
